#####################F###################
#.....#...........#.....#.......#.......#
#.###.#.#.#########.###.#.#####.#.#####.#
#...#...#.#.........#.#...#.....#.#.#...#
###.#####.#.#########.#####.#####.#.#.###
#.#...#...#.#.......#...#...#.....#.#...#
#.###.#.###.#.#####.###.#.#.#.#####.###.#
#.....#...#.#.#.........#.#.#.......#...#
#.#######.#.#.#########.#.#########.#.#.#
#...#...#.....#.......#.#.#.....#...#.#.#
#####.#.#.#####.#####.#.#.#.#.###.###.#.#
#.....#.#.#...#.....#.#.#.#.#.....#...#.#
#######.###.#.#####.#.###.#.#######.###.#
#.....#.....#.#.....#...#.....#...#.#...#
#.###########.#.#######.#####.#.###.#.###
#.......#...#...#.......#...#...#...#...#
#.###.#.#.#.#####.#######.#.###.#.#####.#
#...#.#.#.#.#...#.....#...#.#...#.#...#.#
###.#.###.#.#.#.#####.###.#.#####.#.###.#
#...#.....#...#...........#.......#.....#
#####################I###################